0,0,0,0,0,0,0,0,0,0,0,0,0,0,0,0,0,0,0,0
0,0,0,0,0,0,0,0,0,0,0,0,0,0,0,0,0,0,0,0
0,0,0,0,0,0,0,0,0,0,0,0,0,0,0,0,0,0,0,0
12,0,11,0,13,0,12,0,11,0,13,0,12,0,11,0,13,4,12,4
5,0,0,0,0,0,0,0,0,0,0,0,0,0,0,0,0,0,0,0
5,0,0,0,0,0,0,0,0,1,0,0,0,0,0,0,0,0,0,0
5,0,0,0,0,0,0,0,2,1,2,0,0,0,0,0,0,7,8,0
0,0,3,3,3,3,0,0,7,8,1,0,0,0,0,0,0,9,10,0
0,7,8,0,0,0,0,0,9,10,0,0,0,0,0,0,0,0,0,0
0,9,10,0,7,8,0,0,0,0,0,0,0,11,0,0,0,0,0,0
0,0,0,0,9,10,0,0,0,0,0,0,0,0,0,0,0,0,0,3
0,0,0,0,0,4,4,0,0,0,0,0,0,0,0,0,0,0,0,0
0,0,0,0,0,0,0,0,0,0,0,6,6,0,0,0,0,0,0,0
0,0,0,0,0,12,0,0,13,3,12,6,6,0,0,0,0,0,0,0
0,0,0,0,0,0,0,0,0,0,0,6,6,0,0,0,0,0,0,0
0,0,0,0,0,0,0,11,0,0,0,6,3,3,3,3,0,0,2,0
0,0,0,0,0,0,0,0,7,8,0,0,0,0,2,0,1,0,7,8
0,0,0,0,0,0,0,0,9,10,0,0,0,0,0,2,7,8,9,10
0,0,7,8,6,1,12,0,0,0,0,0,4,4,0,0,9,10,0,0
0,0,9,10,0,0,0,0,0,0,0,0,0,2,1,0,13,0,0,0
0,0,0,0,0,0,0,0,7,8,0,0,0,0,2,0,0,0,0,0
0,0,0,11,0,0,0,0,9,10,0,0,0,0,0,0,0,0,0,0
3,3,0,0,0,0,0,6,7,8,0,4,4,4,4,0,0,3,3,3
0,0,0,0,0,0,2,6,9,10,0,0,0,0,0,0,11,0,0,0
3,3,0,0,0,0,0,6,0,0,0,0,0,0,0,0,0,0,0,3
0,0,0,0,0,1,1,6,0,4,4,4,0,0,0,0,0,0,0,0
0,0,0,12,0,1,1,0,0,3,3,3,0,0,0,0,0,0,0,0
7,8,0,0,0,1,2,0,0,0,0,0,0,0,0,0,0,0,0,1
9,10,0,0,0,0,0,0,0,0,0,0,0,5,0,7,8,0,0,2
0,0,6,0,0,0,0,0,0,0,0,0,0,0,0,9,10,0,0,2
0,0,6,0,0,0,0,0,0,3,3,3,0,0,0,0,0,2,0,1
0,6,6,0,0,0,0,0,0,0,0,0,0,7,8,0,0,1,1,0
12,0,11,0,13,0,12,0,11,0,13,0,12,0,11,0,13,4,12,4
0,0,0,0,0,0,0,0,0,0,0,0,0,0,0,0,0,0,0,0
0,0,0,0,0,0,0,0,0,0,0,0,0,0,0,0,0,0,0,0
0,0,0,0,0,0,0,0,0,0,0,0,0,0,0,0,0,0,0,0