0,0,0,0,0,0,0,0,0,0,0,0,0,0,0,0,0,0,0,0
0,0,0,0,0,0,0,0,0,0,0,0,0,0,0,0,0,0,0,0
0,0,0,0,0,0,0,0,0,0,0,0,0,0,0,0,0,0,0,0
0,0,4,0,0,0,0,0,0,0,0,0,0,0,0,0,0,0,0,0
0,0,0,0,0,0,0,0,0,0,0,0,1,0,0,0,0,0,0,0
0,3,3,6,4,4,4,4,0,7,8,0,0,2,0,0,0,0,0,0
0,0,0,6,0,0,0,0,0,9,10,0,0,0,0,0,0,0,0,0
0,0,0,0,6,0,0,0,0,0,0,0,0,0,0,0,7,8,0,0
0,0,0,0,6,7,8,0,0,0,0,0,0,0,0,0,9,10,0,0
0,0,0,0,6,9,10,0,0,0,0,0,0,0,0,0,0,0,0,0
5,0,0,0,6,0,0,0,0,0,0,0,0,0,0,0,0,0,0,0
5,0,0,2,0,0,0,0,0,0,0,0,0,0,0,0,0,0,0,0
5,0,0,1,2,1,0,0,0,0,0,0,0,0,0,0,0,0,0,0
0,0,0,1,1,0,0,0,0,0,0,0,0,0,0,0,12,0,0,0
0,0,0,1,0,0,12,0,0,0,0,0,0,0,0,0,0,0,0,0
5,0,0,0,0,0,0,0,0,0,0,0,0,0,0,0,0,0,0,0
5,0,0,0,0,0,0,0,0,0,0,0,0,0,0,3,0,0,0,0
0,0,0,0,0,0,11,0,0,3,3,3,3,0,0,7,8,11,0,0
0,0,0,0,0,0,0,0,0,0,0,0,0,0,0,9,10,0,0,0
0,0,12,3,3,3,3,0,0,0,0,0,0,0,0,11,1,0,0,0
0,0,0,11,0,0,11,0,0,7,8,0,0,0,0,0,0,2,7,8
2,0,0,0,0,0,0,0,0,9,10,0,0,0,0,7,8,0,9,10
2,0,0,0,0,0,0,0,0,0,0,0,0,0,0,9,10,0,0,0
0,1,0,0,0,0,0,0,0,0,0,0,0,0,0,0,4,4,0,0
0,0,0,0,4,4,4,4,0,0,0,0,0,0,3,3,0,0,0,0
1,0,0,11,0,0,0,0,7,8,7,8,0,0,0,0,0,0,6,0
0,0,0,0,0,0,0,0,9,10,9,10,0,1,0,0,0,0,6,0
0,7,8,0,0,0,0,0,0,0,0,1,1,2,0,0,0,0,6,0
0,9,10,0,0,0,2,0,0,0,0,0,1,0,3,3,0,0,6,0
0,0,0,0,0,2,1,0,0,0,0,2,0,0,0,0,0,0,0,0
3,3,0,0,0,2,0,0,0,0,0,0,0,7,8,1,2,0,3,3
0,0,7,8,0,7,8,0,0,0,0,0,0,9,10,2,0,6,0,0
0,0,9,10,0,9,10,0,3,3,3,3,0,0,0,0,0,0,0,0
0,0,0,0,0,0,0,0,0,0,0,0,0,0,0,0,0,0,0,0
0,0,0,0,0,0,0,0,0,0,0,0,0,0,0,0,0,0,0,0
0,0,0,0,0,0,0,0,0,0,0,0,0,0,0,0,0,0,0,0