0,0,0,0,0,0,0,0,0,0,0,0,0,0,0,0,0,0,0,0
0,0,0,0,0,0,0,0,0,0,0,0,0,0,0,0,0,0,0,0
0,0,0,0,0,0,0,0,0,0,0,0,0,0,0,0,0,0,0,0
0,0,0,0,0,7,8,0,0,2,0,0,0,0,0,6,0,0,0,0
0,0,0,0,0,9,10,0,0,0,2,0,0,0,0,0,0,0,0,0
0,0,0,0,0,0,7,8,0,0,2,0,0,0,0,0,0,6,0,2
0,0,0,0,7,8,9,10,0,0,0,1,0,0,0,2,0,0,0,0
0,0,0,0,9,10,0,5,0,4,4,0,0,0,0,0,2,1,2,0
0,0,0,0,0,0,0,5,0,0,1,0,0,0,0,0,0,1,2,0
0,0,0,0,0,0,0,0,0,0,1,6,0,0,0,0,0,0,2,0
0,0,0,0,0,0,0,0,0,0,0,6,0,0,4,5,0,0,0,0
0,0,0,0,0,0,0,11,0,12,0,6,0,0,0,5,0,0,0,0
0,0,0,0,0,0,0,0,0,0,0,0,0,0,0,5,7,8,0,6
0,0,0,0,11,0,0,0,0,7,8,0,0,0,0,0,9,10,0,6
0,0,0,0,0,0,0,0,0,9,10,0,0,2,0,3,3,0,0,0
0,0,0,0,0,0,0,0,3,3,3,0,2,0,1,4,4,4,0,0
0,0,0,0,7,8,0,0,0,0,0,11,6,1,0,0,0,0,0,0
0,0,0,0,9,10,0,0,0,0,12,6,6,4,4,0,0,0,0,0
0,0,0,0,0,0,0,0,0,0,0,0,6,0,0,0,0,7,8,0
0,0,0,0,7,8,0,11,0,0,0,0,6,3,3,0,0,9,10,0
0,2,0,0,9,10,11,0,0,0,0,0,0,0,0,0,0,0,0,0
1,0,0,0,0,0,0,0,0,0,0,4,0,7,8,0,0,3,0,0
1,0,0,0,0,11,0,0,0,0,0,0,0,9,10,0,0,0,0,0
1,0,0,0,0,0,0,0,0,0,0,0,0,0,0,0,0,0,0,0
0,0,0,0,0,0,0,0,0,0,0,7,8,0,0,0,0,7,8,0
7,8,0,0,0,0,0,0,4,4,4,9,10,0,0,3,0,9,10,0
9,10,0,0,0,0,0,0,0,0,0,0,0,0,0,0,0,1,1,0
0,0,0,0,0,0,0,0,0,0,0,0,0,0,0,0,0,0,0,1
0,0,0,0,0,0,0,0,0,0,0,0,0,6,0,7,8,0,0,0
0,0,0,0,0,0,0,0,0,5,0,0,0,6,0,9,10,0,0,0
0,0,0,0,0,0,0,0,0,5,0,0,5,0,0,0,0,0,0,0
0,0,0,0,0,0,0,0,0,5,0,0,5,0,0,0,0,0,0,0
0,0,0,0,0,0,0,0,0,0,0,4,5,0,0,0,0,3,0,0
0,0,0,0,0,0,0,0,0,0,0,0,0,0,0,0,0,0,0,0
0,0,0,0,0,0,0,0,0,0,0,0,0,0,0,0,0,0,0,0
0,0,0,0,0,0,0,0,0,0,0,0,0,0,0,0,0,0,0,0